6,10
3,2
**********
*--------*
*--***---*
*-a---f--*
*-*--*---*
**********